HIS	H
ARG	R
LYS	K
ILE	I
PHE	F
LEU	L
TRP	W
ALA	A
MET	M
PRO	P
CYS	C
ASN	N
VAL	V
GLY	G
SER	S
GLN	Q
TYR	Y
ASP	D
GLU	E
THR	T
